121212121
134313431
222242222
111111111
114111411