121212121
131313131
222222222
111111111
111111111