323232323
134313431
424242424
333333333
114141411